12,6 
1,0
8,5
X0XXXXXXXXXX
X0XX0000000X
X00XXX0XXX0X
XX0000000X0X
XXX0XXXX0XXX
XXXXXXXX0XXX
